NO textures/north.xpm
SO textures/south.xpm
WE textures/west.xpm
EA textures/east.xpm

F 128, 128, 128
C 135, 206, 235



1111111111111111111111
10000000000000000000011
1101000111111100000111
11000001     100000111111
10000001     110000000111111
100000011111110000011
1000000000000000000001
1000000000000000000001
1000000000000000000001
1000000000000000010011
1000000000000000000001
1000000000000000000001
1000000000N00000000001
1000000000000000000001
1111111111111111111111
